"a" = (/turf/template_noop,/area/space)
"b" = (/obj/structure/prop/redspace/containment_pylon{icon_state = "pylon_active 0,8"},/turf/template_noop,/area/space)
"c" = (/obj/structure/prop/redspace/containment_pylon{icon_state = "pylon_active 1,8"},/turf/template_noop,/area/space)
"d" = (/obj/structure/prop/redspace/containment_pylon{icon_state = "pylon_active 0,7"},/turf/template_noop,/area/space)
"e" = (/obj/structure/prop/redspace/containment_pylon{icon_state = "pylon_active 1,7"},/turf/template_noop,/area/space)
"f" = (/obj/structure/prop/redspace/containment_pylon{icon_state = "pylon_active 0,6"},/turf/template_noop,/area/space)
"g" = (/obj/structure/prop/redspace/containment_pylon{icon_state = "pylon_active 1,6"},/turf/template_noop,/area/space)
"h" = (/obj/structure/prop/redspace/containment_pylon{icon_state = "pylon_active 0,5"},/turf/simulated/floor/redspace,/area/space)
"i" = (/obj/structure/prop/redspace/containment_pylon{icon_state = "pylon_active 1,5"},/turf/simulated/floor/redspace,/area/space)
"j" = (/turf/simulated/floor/redspace,/area/space)
"k" = (/obj/structure/prop/redspace/containment_pylon{icon_state = "pylon_active 0,6"},/turf/simulated/floor/redspace,/area/space)
"l" = (/obj/structure/prop/redspace/containment_pylon{icon_state = "pylon_active 1,4"},/turf/simulated/floor/redspace,/area/space)
"m" = (/obj/structure/prop/redspace/containment_pylon{icon_state = "pylon_active 0,3"},/turf/simulated/floor/redspace,/area/space)
"n" = (/obj/structure/prop/redspace/containment_pylon{icon_state = "pylon_active 1,3"},/turf/simulated/floor/redspace,/area/space)
"o" = (/obj/structure/prop/redspace/containment_pylon{icon_state = "pylon_active 2,3"},/turf/simulated/floor/redspace,/area/space)
"p" = (/obj/structure/prop/redspace/containment_pylon{icon_state = "pylon_active 0,2"},/turf/simulated/floor/redspace,/area/space)
"q" = (/obj/structure/prop/redspace/containment_pylon{icon_state = "pylon_active 1,2"},/turf/simulated/floor/redspace,/area/space)
"r" = (/obj/structure/prop/redspace/containment_pylon{icon_state = "pylon_active 2,2"},/turf/simulated/floor/redspace,/area/space)
"s" = (/obj/structure/prop/redspace/containment_pylon{icon_state = "pylon_active 0,1"},/turf/simulated/floor/redspace,/area/space)
"t" = (/obj/structure/prop/redspace/containment_pylon{icon_state = "pylon_active 1,1"},/turf/simulated/floor/redspace,/area/space)
"u" = (/obj/structure/prop/redspace/containment_pylon{icon_state = "pylon_active 2,1"},/turf/simulated/floor/redspace,/area/space)
"v" = (/obj/structure/prop/redspace/containment_pylon{icon_state = "pylon_active 0,0"},/turf/simulated/floor/redspace,/area/space)
"w" = (/obj/structure/prop/redspace/containment_pylon{icon_state = "pylon_active 1,0"},/turf/simulated/floor/redspace,/area/space)

(1,1,1) = {"
aaaabcaaaa
aaaadeaaaa
aaaafgaaaa
aaaahiaaaa
aaajkljaaa
aajjmnojaa
ajjjpqrjja
jjjjstujjj
jjjjvwjjjj
ajjjjjjjja
aajjjjjjaa
aaajjjjaaa
aaaajjaaaa
"}
